##########
#........#
#..##....#
##....P..#
#........#
#.#....#.#
##########
